00011100000111000000000000000000000000000000000000000000011100000000000000000000011100000111000000001110000001110000000011100000000000000000
00011101110111000000000000011100011100001110000011100000011100011100000111000000011100000111000000001110000001110011100011100000001110000000
00011101110111100011100000011100011100001110011111100000011100011100000111000000011100000111000000001110011101111011100011100000001110000000
00000001110011100011100001111100011100011110011111100001110000011100000111000000000000000000000000000000011100111011100000000011101110000000
00000000000011100011100001110111000000011100011100000001110000000000000000000000000000000000000000011100011100111000000000000011100011100000
00000011111100000000000001110111000000011100011100000001110001110000000000000001110011100000000000011100000000011100000000000011100011100000
00000011111100000000000000000111011100000000011100000000000001110011100000000001110011111100000000011100000000011100011100000111000011100000
00000011111100000000001110000000011100000000011100000000000001110011100000000001110011111100000000000000000000011111111100000111000011111000
00000000011100000000001110000000011111100001110000000011101110000011100001110000001110011100111000000000000000000011111100000111111011111000
00000000011100000000001111111000000011100001110000000011101110000000000001110011101111100111111001110000000000000011100000001110111000111000
00000001111100111000000111111000000011100001110011100011101110000000111001110011101111100111111001110000000000000001110011101110111000000000
00011101110000111000000111111000000000000000000011100000000000000000111111000011100011100111000001110111000000000001110011101110000000000000
00011101111110111000000000001110000111000000000011100000000000011100111111000000000000000000001110000111000000000001110011100000000000111000
00011100001110000000000000001110000111111000000011111000111000011100000111100000111000000000001110001111000000000000000000000000000000111000
00000000001111000000000001111110000111111000000011111000111000011100000011100000111000011100001110001110000000011100000001110000111000111000
00000111000111000111000001110000000000111000000000111000111000111000000011100111111000011100000000001110001110011100000001110000111000000000
00000111000111000111000001110001110000011100000000000000000000111000000000000111000000011100000000001110001110011100000001110000111000000000
00000111000000000111000111000001110000011100000011100000000000111000000001110111111000000000000000001110001110111000000001111110000000000000
00000000000000000000000111000001110000011100000011100111000000000000000001110000111000000000000000001110000000111000000001111110000000000000
00000000111000000000000111000011100000111000000011100111001110000000000001110000111000000000000000000000000000111100000011111110000000000000
00000000111001110000000000000011100000111000000000000111111111110000000000000000001110011111100000111000000000011100000011100000000011100000
00000000111001110011100000000011100000111000000000011100111111110000000000000000001110011111100000111000000111011100000011100011100011100000
00011100001111110011100001110111000000001110000000011100111001110011100000000111001110011111100000111000000111000000000000000011100111100000
00011100001111110011100001110111000000001110000000011100000000000011100000000111000000000000000000000000000111000000001110000011100111000000
00011100001111110000000001110111000001111110000000001110000000000011100000000111000011100000111000000000000000000000001110000000000111011100
00111000011101110000000000000001110001110000011100001110000000000000001110000001110011100000111000000001110001110000001110000000000000011100
00111000011100000000000000111001110001110000011100001110000000000000001110000001110011100000111000000001110001110000000000000000011100011100
00111000011100011100000000111011110000000000011100000000000011100000001110000001110000000000000000000001110001110000011111000000011100000000
00000000000000011100000000111011100000000000000000000000011111100000000000000000000000011100000000000000000000000000011111000000011100111000
00000011100111011100000000000011100000000000000000000111011111100000000000000000000000011100000000000000000001110000011111000000000000111000
00000011100111000000000000000000111000000000000111000111011111000000000000000011100000011111000000011100111001110000000000000111000011111000
00000011100111000000000011111000111000001110000111000111000111000000111000000011100000000111000000011100111001110000001110000111000011100000
00000000000000000000000011111000111000001111110111000000000000000000111000000011100011100111000011111100111001110000001110000111000011100000
00000000011100000000000011111001110011101111110000001110000000011100111000000000000011100000000011100000000001110000001110000000000011100000
00000001111100000000000000000001111111100001110000001110000111011111111100000000000011110000000011100000000000000000000000000000000011100000
00111001111100000000000001110001111111100000000001111110000111011111111100000111011101110000000000001110011100001110000000000000000000000000
00111001110000011100000001110000011100000000000001110000000111000011111100000111011101110000111000001110011100001110000000001110000011100000
00111000000000011100000001110000000000000011100001110000000000000000000000000111011100000000111000001110011100001110000000001110000011100000
00000111001110011100000000001110001110000011100000000000000000111111000011100000000000000000111000000000000000000000000000001110000011100000
00000111001110001110000000001110001110011111100000000000000000111111000011100000111000000000000000000001110000000000000000000000000000000000
00000111001110001110000000001110001110011100011100011100000000111111011111100000111000000000000000111001110011100000001110111000000000011100
00000000000000001111101110000000000000011100011100011100000000001110011100001110111111011100000000111001110011100001111110111000000000011100
00000001110111000011101110000000000000000011111100011100001110001110011100001110000111011100111000111000000011100001111110111001110011111100
00000001110111000011101110000001110000000011100000000000001110001110000000001110111111011100111000000000000000000001110000000001110011100000
00000001110111000000000000000001110000000011100000011100001110001110000000000000111000000000111000000001110000000000000000000111110011100000
00000000000000000000011100000001110000000000000000011100000000001110000000001110111000000000000000000001110000000000000111000111001110000000
00000000000000000000011100000000001110000000000000011100000000001110000000001110000001110000000000000001110000000000000111000111001110000000
00000000000001110011111100000000001110000011100000000000000000000001110000001110000001110000000000000000000001110011100111001110001110111000
00000000000001110011100000001110001110000011100000000000000000000001110001110111000001111110111000000011100001110011111100001110000000111000
00000000011101110011100000001110000000000011101110000000000000000001110001110111000000001110111000000011100001110011111100001111110000111000
00000000011100000000011100001110111000000000001110000000000111000000000001110111000000001110111000000011111000000000011100000001111100000000
00000000011111100000011100000011111000000000001110000011100111000000001110000000111000111000000000000000111000000011100000000001111100000000
00000000000011100000011110000011111000000000000001110011100111011100001110000000111000111000000000000000111000000011100000000000011100000000
00000111000011100000001110000011100000001110000001110011100000011100001110000000111000111001111110000000000000000011111100000000000000000000
00000111000011100011101110000000000000001110000001110000000011111111100000000000111000000001111110000000011100011100011100011100000000000000
00000111000011100011100000000011100000001110000000000000011111100011100011100000111110000001111110011100011100011100011111111100000001111100
00000000000001110011111100111011100000000111000000000000011111100011100011100000111110011100000000011100011100011100000011111100000001111100
00000000000001110000011100111011100000000111000000000011111100000011100011100000001110011100000000011100000000000000011111100000000001111100
00000000001111110000011100111000011100000111000000000011100001110011100000000000001110011100000000000000000000000000011100000000000000000000
00000000001110000000111000000000011100000000000000000011100001110011100000000000001111110000000000000000000000111000011100000011100000000000
00000000001110000000111000000000011100111000000000000000001111110000000000111000001111110000000000000000000000111000000000000011100000000000
00111011100000000000111000000001110000111000000000000000001110000000000000111000000001110000001110000000000000111000000000000111100011100000
00111011100000000111000001110001110000111000000011100111001110000000000000111000000000000000001110000011100000000111000000000111110011100000
00111011100000000111000001110001110000000000011111100111000111001110000000111000011100000000001110000011100000000111011100000111110011100000
00011100000001110111000001110000000000000000011111100111000111001110000011111000011100000000111000000011100000000111111100000001111100000000
00011100000001110000000000000011100001110000011100000000000111001111110011111000011100011100111001110011100000000001111100000000011100000000
00011100000001110000000000000011100001110000000011100000000000000001110011100000001110011100111001110011100000000001110111000000011100000000
00000000000000000000000000111011100001110111011111100000000000000001110001110000001110011100000001110000000011100000000111000000000000000000
00000000000000111000000000111000000000000111011111100000000011100000000001110000001110000000000000000000000011100000000111000011100000000000
00000000000011111000111000111000111000000111011100000000000011100000000111110000000000000011100000000011100011100000000000000011100000000000
00000000111011111000111000000000111000000111000000000011100011100000000111000000000000111011100000000011100000000000000000000011100000000000
00000000111011100000111000000000111000000111000000000011100000000000000111000000000000111011100000000011100000000000000000000000000000000000
00000000111011100000000000000000000000000000000000000011100000000000000000000000011100111111011100000000000000000000011100000001110000000000
00000000000011100000000000001110000000000000000000000000000000000000000000001110011100000111011111000001110011100000011100000001110011100000
00000011100011100000000000001110000000111000000000000000000000000111000000001110011110000111011111000001110011100111011100000001110011100000
00000011100000000000000000001110000000111000000011100000111011100111000000001110001110000000000111000001110011100111000000000001110011100000
00000011100000000000000011100000000000111000000011100000111011100111000000000000001110000011100000000000111000000111000000000001110000000000
00000000011100000000000011100000000000000000000011100000111011100011100000000000001110000011100001110000111000000000000111000000000000000000
00000000011100000000000011100000111011100000011100011100000011100011100000000000001110000011100001111110111000000000000111000011100000000000
00000000011111100000000000000000111011100000011100011100000011100011100000000000001110000000000001111110000000000111000111111011100011100000
00001110000011100000000000000000111011100111111100011100000011100000000000000000000000000000000000001110000011100111110000111011100011100000
00001110000011100000000111000000111000000111110000000000000000000000111110000000111000111000000000000011100011100111110000111000000011100000
00001111110011100000000111000000111000000111110000000000000011100000111110000000111000111000000000000011100011100111110000000000000000000000
00000001110011100000000111111000000000111000000111000000011111100000111110000000111000111000000000000011100000000111000111000111000001110000
00000001110000000000000000111000000000111000000111000000011111100000000000000000000000000000000111000000000000000001110111000111000001110000
00000000011100000000000000111000000000111000000111000000011100000000000000000000000000000000011111001110000011101111110111000111111001110000
00000111011101110000001110000001110000000000000000000000000111000000000000000111001110000000011111001110000011101111110000000000111000000000
00000111011101110000001110001111110000011100000000000000000111000000000000000111001110001110011100001110000011101110000000111000111000000000
00000111100001110000001110001111110000011100011100000000001111000000001110000111001110001110000000000001110111000000000000111111000000000000
00000011100000001111110011101110001110011100011100000111001110111000111110000000000000001110000000000001110111000000000000111111000000000000
00000011100000001111110011100000001110000000011100000111001111111000111110000000000000000000000000111001110111000000000000000111000011111100
00000000000000001111110011100000001110000000000000001111000111111000111000000000000000000000000000111000000000000000000000000111000011111100
00000000000000000000011100000000000000000000000000001110000111000000000111000000000000000000011100111000000111000000111111000111011111111100
00111000000000000000011100000000000000000000000000001110000000000000000111000000000111000000011100000000000111000000111111000111011100000000
00111000000000000000011100000000001110000000000000000000000000000000000111000011100111000000011100000111000111011100111111001110011100111000
00111000000000000000011100000000001110000000000000000111001111110000000000000011100111110000000000000111000000011100000000001110000000111000
00001110000000001110011100001110001110000000000000000111001111110000000000111011100001110000000000000111000000011100000000001110011100111000
00001110000000001110011100001110000011100000000000000111001111110000111000111000000001110000111110000111000000000000000000000001111100000000
00111110000000001110000000001110000011100000011100000111000000000000111000111000000000000000111110001111000000000000011100000001111100000000
00111000000001110011100000000000011111111100011100000111000000000000111000011100000000000000111110001110000001110000011100000001110000000000
00111000000001110011100000011100011100011100011101110111011100011100000000011100111000000000000000001110000001110000011100000000000111000000
00001110000001110011100000011100011100011100000001111110011100011100000000011100111000111011101110000000000001110000000000000000011111000000
00001110000001110000000000011100000000011100000001111110011100011100000001110000111000111011101110000000000000000000000111111000011111000000
00001111110001110000000000000000000000011100000000001110000000000000000001110000000000111011101110000001110000000000000111111000011110000000
00000001110001110000000000001110111000011111100000001110001110000111000001110011100000000000000000000001111110000000000111111000001110000000
00000001111100000000000011101110111000000011100000001110111110000111000000000011100000000000001110000001111110001110000000000000001110000000
00000001111100000011100011101110111000000011100000011110111110000111000000011111111000000000001110000000001110001110011100000000000000000000
00000001111100000011111111100111000000001110000000011100111000000000111000011100111000000000001110000011100000001110011100000000000000000000
00000001111100000011111111000111110000001110000000011100000000001110111000011100111110000000000000000011100000000000011100000011100000111000
00000000011100000000011111000111110000001110000000000000011100001110111000000011101110000111000000000011101110000001110000011111100000111000
00000000011100000000000111000111110000000000000000000000011100001110001110000011101110000111000001110000001110000001110111011111100000111000
00000000000000000000000000000111000000000000000000000011111110000000001111100011100111000111000001110000001111000001110111011100111000000000
00000000111000000001110000000111000000111000000000000011101110000011101111100011100111000000000001110000000111000000000111000000111000011100
00000000111000000001110000000000000000111000000011100011101110000011100011100011100111000000011100001110000111000000111000011100111000011100
00011100111000011101110000000000000000111000000011100000000111000011100000000011100000000000011100001110000000000000111000011100011100011100
00011100000000011100000000011100000000000000001111100000000111000000000000001110000000111000011100001110000000000000111000011100011100000000
00011100000111011100000000011100000000000000001110000000000111000000000000001110000000111001110000000000000000111000000000000000011100111000
00011100000111000000000000011100000000000000001110000000000000000000000000111110000000111001110000000000000000111000111000000000000000111000
00011100001111000000000111011100000000111000000111000011100000111000000000111000000000011101110000000000111000111000111001110000000011111000
00011100001110000011100111011100000111111000000111111011100000111000000000111000000000011100000000000000111000000000111001110111000011100000
00000000001110011111111111011100000111111000000111111011100000111011100000000000000000011100000000000000111000000000000001110111000011100000
00000111000000011111111100000000000111000000000000111011100000000011100000000000000000000000011100000000000000111000000000000111000000000000
00111111000000011100011101110000000000000000000000000011111000000011100000011100000000000000011100000000111000111000000001110000000000011100
00111111000000000000000001110111000000000000000000000011111000000000011100011100111000111000011100000000111000111000001111110001110000011100
00111000000000000000000001110111000000001110000000000000111000011100011100011100111000111000000000000000111000011100001111110001110000111100
00000000000000000000000011100111000011101110000011100000000000011101111100011100111000111000000011100011100000011100001110000001111100111000
00001110000000000000000011100000111011101110000011100000000000011101110000011100000000111000000011100011100000011100000000001110011100111000
00001110000000000000000011100111111011100000000011100000000000000001110000000000000000111000000011100011100000000000000011101110011100111000
00111110000000000000000000000111111110000000001110000000000000000000000000000000000000111000011100000011100000000001110011101110001110111000
00111000000000111000011111100111001110000000001110000000000000011100000000011100000000000000011100000011111100000001110011100111001110111100
00111000000000111000011111100000001110000000001110011100000000011100000000011100001110000000011100001110011100000001110000000111001110011100
00000000000000111000011111100001110000001110001111111100000000011100011100011100001110000111000000001110011100000000000000000111111000011100
00000011100000111000001110000001110000001110001111111100000000000000011100000000111110000111000000001110011100000000000000000000111000000000
00000011100000111001111111100001110000001110001111100000000000000000011100000000111000000111000111000000011100111011100000000000111000000000
00001111100000111001110011100000000000000000000000000000000000000000000001110000111000000000000111000000011111111011100111000000000000000000
00001110000000111001110011111100000000000000000000000000000000000000000001110000000000000000000111000001110011111011100111000011100000000000
00001110000000111000000000011100011101110000000111000000000000000000000001111000000000111000000000000001110011100000000111000011100000000000
00000001110000011100000000011100011101110011100111000000000011100000000011111000000000111000001110011101110001110000001110000011100111011100
00000001110000011100000000000000011101110011100111000000000011100000000011111000000000111000001110011100000001110000001110000000000111011100
00000001110000011100000000000000000000000011100000000000000011100000000011100000000000000000001110011100000001110000001110000000000111011100
